C 50,    100, 200
F 50, 200, 200
R 400 4000
NO      ./textures/redbrick.xpm
SO      ./textures/bluestone.xpm
WE      ./textures/greystone.xpm
EA      ./textures/redbrick.xpm
S ./textures/barrel.xpm



        1111111111111111111111111
        1022222222112222000000001
        1211222221112222000000001
        12212222222222220000W0001
111111111211222221112222000000001
122222222211222221112111000011111
11112111111111211122222202221
11112111111111211121212202221
11222222112121211122222202021
12222222022222221122222212221 
12222222222221221121221212221        1
11222221112121211111211112221
11111111111111111111111111111
11111111111111111111111111111
11112111 1112121 121111212221
11111111 1111111 111111111111
11
