S ./textures/barrel.xpm
EA ./textures/greystone.xpm
WE ./textures/eagle.xpm
NO ./textures/bluestone.xpm
SO ./textures/redbrick.xpm
C 5, 150, 155
F 22, 120, 1
R 800 600
11111
10001
10201
10001
10201
10001
10201
10001
10201
10001
10201
10001
10201
10001
10201
10001
10201
10001
10201
10001
10201
10001
10201
10001
10201
10001
10201
10001
10201
10001
10201
10001
10201
10001
10201
10001
10201
10001
10201
10001
10201
10001
10201
10001
10201
10001
10201
10001
10201
10001
10201
10001
10201
10001
10201
10001
10201
10001
10201
10001
10201
10001
10201
10001
10201
10001
10201
10001
10201
10001
10201
10001
10201
10001
10201
10001
10201
10001
10201
10001
10201
10001
10201
10001
10201
10001
10201
10001
10201
10001
10N01
11111
