F 0,120,10
EA ./textures/greystone.xpm
WE ./textures/bluestone.xpm
NO ./textures/eagle.xpm
SO ./textures/redbrick.xpm
C 1,150,255
S ./textures/barrel.xpm
R 800 17000

 1  
11111111111111111
10000002000000001111111111
10000000000000001111111111
10000000000000001 1
100000000000000011
10000000000000001
10000000000200001
10000000000000001
10020000000000001
10000000000000001
10000002000000001
10000000000000001                  1
10200000N00000001
10000000000000001
10000000000000001
10000000000000001
11111111111111111
