R 400 4000
NO      ./textures/eagle.xpm
SO      ./textures/bluestone.xpm
WE      ./textures/greystone.xpm
EA      ./textures/redbrick.xpm
F 0200, 00000000050, 00000000000
S ./textures/barrel.xpm
C 00,    200, 0100

        1111111111111111111111111
        1000000000000000000000001
        1000000000000000000000001
        1000000000000000000000001
111111111000000000S00000000000001
122222222000000000000000000011111
11112111100000000000000000001
11112111100000000000000000001
11222222100000000000000000001
12222222000000000000000000001 
12222222222221221121221212221
11222221112121211111211112221
11111111111111111111111111111
11111111111111111111111111111
11112111 1112121 121111212221
11111111 1111111 111111111111
11
